##################################################
##....####################......##################
##....####################.####..#################
##....################........##..################
##.###########.......#........###..###############
##.###########................####..##############
##.###################........#####..#############
##..#...#....#########........######.#############
##..#...#....#########........#..........#########
##..#...#....#########........#..........#########
##..#...#....#########........#..........#########
##..##.####.###################..........#########
##.......................................#########
##............................#..........#########
##..##.####.###################..........#########
##..#...#....##################..........#########
##..#...#....##################..........#########
##..#...#....##################..........#########
####################################.#############
###################################...############
###################################...############
########################..........#...#......#####
########################..............#......#####
#########################.##########..#......#####
#######################.....########..#......#####
########################...#########.........#####
##################################################