##########
#####....#
###....#.#
###.#..#.#
#####.#..#
#.....#.##
#.##..#..#
#.##..#.##
#.....#..#
##########