###############.####
#..................#
#..................#
#..................#
#.......##.....#...#
#...##.............#
#..................#
#..................#
#.....##...........#
#.....##...........#
#..................#
#...................
#...................
#...................
...........#.......#
...........#.......#
...........#.......#
#..........#.......#
##.................#
#############...####
#############...####
#############...####
#############...####
#############...####
##..............####
#############...####
#############...####
#############...####
#############...####
#############...####
#############...####
#############...####
#############...####
##########......####
#############...####
#############...####
#############...####
#############...####
#######.........####
#############...####
#############...####
#############...####
#############...####
